2 6 14 12 12 10 6 12 12 10 
3 1 3 6 10 3 3 2 6 9 
5 12 9 3 3 5 9 7 9 2 
2 6 12 9 5 14 10 5 12 11 
3 5 10 4 10 3 5 8 6 9 
3 6 13 12 11 5 12 10 5 10 
5 9 6 10 1 6 12 11 6 9 
6 12 9 3 6 9 4 9 5 10 
3 6 10 5 9 6 10 6 12 9 
5 9 5 12 12 9 5 13 12 8 
