4 10 6 10 4 12 14 12 10 2 
2 3 3 5 12 12 9 2 3 3 
3 5 9 6 10 6 14 11 3 3 
7 12 10 1 5 9 3 3 5 11 
7 10 5 10 6 12 9 7 8 3 
3 5 10 5 11 6 10 3 6 9 
3 6 9 4 9 3 3 1 3 2 
3 5 12 10 6 9 3 6 9 3 
5 10 6 9 5 10 5 9 4 11 
4 9 5 12 12 13 12 12 12 9 
