2 2 6 12 14 10 4 12 14 10 
3 3 3 2 3 5 12 10 3 3 
3 7 13 9 3 4 12 11 1 3 
3 3 6 10 5 12 10 5 12 11 
3 1 3 3 6 12 9 4 14 9 
3 6 9 3 5 12 14 10 5 10 
5 9 2 5 12 10 3 3 4 11 
6 12 13 10 2 3 1 5 10 1 
3 6 10 5 9 5 12 10 5 10 
5 9 5 12 12 12 12 13 12 9 
