2 6 10 4 10 6 14 8 6 10 
3 3 5 10 7 9 5 12 9 3 
5 9 2 3 7 12 12 8 6 11 
2 6 13 9 1 6 12 10 3 1 
7 9 4 14 10 3 2 3 5 10 
3 4 14 9 5 9 3 3 6 11 
3 6 9 6 12 12 11 5 9 3 
5 9 2 7 12 10 5 12 8 3 
6 10 7 9 2 5 10 6 12 9 
1 5 13 12 13 8 5 13 12 8 
